NO textures/NO.xpm
SO textures/SO.xpm
WE textures/WE.xpm
EA textures/EA.xpm

F 60,70,70
C 40,40,40

111111111111111111111111
100D00000011000000000001
101100001111011111111001
100100000010000000010011111111111
101111111D11000001110000000000001
11100000001100000111011111D111111
11110111111111011100000010001
11110111111111011101010010001
11000000110101011101000010001
10000000000000010001000110001
10011100000000011101010010001
10000001110101011101011110N0111
10010101 1110101 101111010001
11111111 1111111 111111111111
