NO textures/1_NO.xpm
SO textures/1_SO.xpm
WE textures/1_WE.xpm
EA textures/1_EA.xpm

F 70,60,60
C 0,0,0

111111111111111111111
101000001000000000001
100010100011100011101
111110111111110110001
100000000100010000101
111111110101011111101
100000000101000000001
101111011111110111101
100001000000010000101
101101111111011100101
101000000001000001101
101000000001111100001
111111010111000111101
1E0000010000010000101
111111111111111111111
