NO textures/NO.xpm
SO textures/SO.xpm
WE textures/WE.xpm
EA textures/EA.xpm

F 60,70,70
C 40,40,40

111111111111111111111111
100000000011000000000001
101100001111011111111001
100100000010000000010011111111111
101111111011000001110000000000001
111000000011000001110111110111111
11110111111111011100000010001
11110111111111011101010010001
11000000110101011100000010001
10000000000000011000000110001
10011100000000001101010010001
10000001110101011111011110N0111
10010101 1110101 101111010001
11111111 1111111 111111111111
